              #####
              # X #
              #   #
      #########   #    ################################################################################
      #           #    #
      #   #########    #    #############################################     #########################
      #   #            #    #                                           #     #
      #   ##############    #                                           #     #
      #                     #                                           #     #
#######   ###################                                           #     #
#         #                                                             #     #
#   #######                                                             #     #
#   #                                                                   #     #
#   #                                                                   #     #
#   #####################################################################     #########################
#
#
#                                                                                               $
#######################################################################################################
