X   #                       ## #
#### #######  ## # ## ###################################
## #######     # ##### #############################
######   ####### # # #############################
######              ###########################
#### #  ## ## ## # #
#####################################
                           #######             ########################
                                         # ###
                ######################### #   ##########
##########################################################
        $                     # # # # # # ##   ## ### ## ## ##

# # # # # ## # # # # # # # # # ## # # # # # ##############
