X #                                                                            ##
 ### ## ###  ### ## # ## ## # ## ## # ##                                      ##
X# ###################                                                       ##
X #                           ###      ###   ## ## # # ## # ##        ###
#  # # # # ## # # # # ## # ## # # # # ## # # #  # # # # #  # ## # # ##
################                                                   #########
                                                                    ### $ ##
                                                                    ######
